Margarita:
Vesuvio: skinka
Alfunghi: champinjoner
Capricciosa: skinka, champinjoner
Hawaii: skinka, ananas
Venezia: skinka, räkor
Tutti Frutti: banan, ananas
Tonno: tonfisk
Paesana: lök, bacon
Calzone: skinka
Cacclatora: salami
Bologna: köttfärs
LHC Pizza: skinka, tonfisk, tomater
Vegetaria: paprika, lök, oliver, champinjoner, kronärtskocka
Mozzarella: mozzarella
Honolulu: skinka, banan, ananas, curry
Ciciliana: tonfisk, räkor
Paradiso: champinjoner, räkor
Kebabpizza: kebab, lök, paprika, kebabsås, fefferoni
Mexicana: köttfärs, lök, paprika
Kebabbåt: kebab, champinjoner, lök, kebabsås
Opera: bacon, salami, lök
Quattro Stagioni: skinka, musslor, räkor, champinjoner, kronärtskocka
68ans special: fläskfilé, gorgonzola, champinjoner
Tropicana: fläskfilé, banan, bea, curry
Poker: oxfilé, tomater, champinjoner, bea
Oscar: fläskfilé, champinjoner, bea
Black & White: oxfilé, fläskfilé, bea
Kyckling Pizza: kyckling, lök, tomater, kebabsås, curry
Caprece: tomater, soltorkade tomater, mozzarella, pesto, ruccola
Pepperoni: pepperoni (korv), ruccola
Fetaost Pizza: tomater, soltorkade tomater, feta, ruccola
Long John: skinka, räkor, tonfisk
Kebabpizza special: kebab, lök, isbergssallad, tomater, gurka, fefferoni, kebabsås
Studenten: kebab, pommes, fefferoni, kebabsås
Huset speciale: oxfilé, soltorkade tomater, champinjoner, ruccola
Provencale special: champinjoner, oxfilé, vitlök
Falafel pizza: falafel, lök, tomater, pommes, kebabsås
De chef: oxfilé, sparris, bacon, tomater, bea
Maif: kebab, skinka, kebabsås
Kycklingpizza special: kyckling, lök, isbergssallad, tomater, gurka, fefferoni, kebabsås
Kyckling Studenten: kyckling, fefferoni, pommes, kebabsås
Capri super: skinka, champinjoner, oxfilé, fläskfilé, bea
Parma: lufttorkad skinka, ruccola, parmesan
Italiana: lufttorkad skinka, soltorkade tomater, vitlök, ruccola
Grigliata: aubergine, zucchini, paprika, soltorkade tomater, lufttorkad skinka, ruccola, parmesan
Vegetaria Special: champinjoner, paprika, aubergine, zucchini, soltorkade tomater, ruccola, parmesan
Quattro formaggio: camembert, gorgonzola, mozzarella, parmesan
Jalapeno: oxfilé, fläskfilé, jalapeno, bea
La camembert: champinjoner, tomater, camembert, lufttorkad skinka
Bella Roma: lufttorkad skinka, salami, mortadella, parmesan, ruccola