Den Enkla: 
Svingod: skinka, champinjoner
Drömmen: köttfärs, paprika
Pizzabakaren Special: köttfärs, lök, bacon
Hawii 5-0: köttfärs, lök, ananas
Mix: pepperoni (korv), lök, paprika
El Mexico: kyckling, oxfilé, nachochips, vitlök, majs, chili
Biffen: bacon, oxfilé, vitlök
Den Marinerade: champinjoner, lök, oxfilé
Pepparbiffen: oxfilé, champinjoner, paprika, lök
Flamman: köttfärs, nachochips, jalapeno
Tacokycklingen: tacosås, kyckling, nachochips, jalapeno
Kockens Kyckling: champinjoner, lök, kyckling, majs
Kockens Favorit: köttfärs, bacon, ananas
Gnistan: köttfärs, lök, vitlök, jalapeno
Kyckling De Luxe: bacon, paprika, lök, kyckling
Pestokycklingen: kyckling, chili, pesto, tomater
Vegetarianen: ananas, champinjoner, paprika, lök, majs
Kebaben: tacosås, majs, jalapeno, kebab, rödlök
Farmen: skinka, bacon
MR.X: köttfärs, ananas, lök, pepperoni (korv)
Chorizo Special: chorizo, lök, oxfilé
Dubbeldäckaren: skinka, köttfärs, oregano
Hot Hawaii Kyckling: bacon, ananas, kyckling
Chorizon: chorizo, oregano, pesto, tomater
Moby Dick: tonfisk, lök
Grekisk Special: feta, paprika, fefferoni, oliver
Kempegod: pepparbiff, paprika, pepperoni (korv)
Tropicana: kyckling, banan, ananas, curry
Kebab Special: kebab, rödlök, fefferoni, isbergssallad, tomater