Margarita
Fungi: champinjoner
Vesuvio: skinka
Tonno: tonfisk
Tutti Frutti: skinka, ananas, banan
Hawaii: skinka, ananas
Capricciosa: skinka, champinjoner
Sorrento: skinka, räkor
Calzone: skinka
Paradiso: räkor, champinjoner
Paesana: bacon, lök
Tropicana: skinka, räkor, banan, fläskfilé
Mexicana: köttfärs, paprika, lök, jalapeno
Gyros pizza: gyroskött, lök, paprika, fefferoni, kebabsås
Kycklingpizza: kyckling, lök, paprika, fefferoni, kebabsås
Falafelpizza: falafel, lök, paprika, fefferoni, kebabsås
Laluna: salami, champinjoner, oliver
Opera: champinjoner, lök, salami, bacon
Poker: oxfilé, fläskfilé, bea, champinjoner
Vegetaria: champinjoner, lök, paprika, oliver, kronärtskocka
Long john: skinka, räkor, tonfisk
La maffia: salami, champinjoner, oliver, ruccola, mozzarella
Kebabbåt: gyroskött, isbergssallad, tomater, fefferoni, kebabsås
Nerso: tomater, champinjoner, oxfilé, vitlök, mozzarella, ruccola
Italy: salami, oliver, paprika, bacon, mozzarella, ruccola
La fontana: feta, champinjoner, kronärtskocka, paprika, vitlök, tomater, mozzarella, ruccola
Mjärdevi Special: gyroskött, sallad, kebabsås
Afandi: halloumi, oliver, körsbärstomater, balsamicreme, ruccola, mozzarella
Caprese: buffelmozzarella, körsbärstomater, oliver, balsamicreme, ruccola
Venezia: soltorkade tomater, mozzarella, lufttorkad skinka, ruccola